19:19
2 2 2 2 2 2 2 2 2 2 2 2 2 2 2 2 2 2 2
2 3 0 4 4 4 4 4 2 0 2 4 4 4 4 4 0 35 2 
2 0 2 4 2 4 2 4 2 0 2 4 2 4 2 4 2 0 2
2 4 4 4 4 4 4 4 2 0 2 4 4 4 4 4 4 4 2
2 4 2 4 2 4 2 4 2 0 2 4 2 4 2 4 2 4 2
2 4 4 4 4 4 4 4 2 0 2 4 4 4 4 4 4 4 2
2 4 2 4 2 4 2 4 2 0 2 4 2 4 2 4 2 4 2
2 4 4 4 4 4 4 4 4 0 4 4 4 4 4 4 4 4 2
2 2 2 2 2 2 2 4 2 0 2 4 2 2 2 2 2 2 2
2 0 0 0 0 0 0 0 0 0 0 0 0 0 0 0 0 0 0
2 2 2 2 2 2 2 4 2 0 2 4 2 2 2 2 2 2 2
2 4 4 4 4 4 4 4 2 0 2 4 4 4 4 4 4 4 2
2 4 2 4 2 4 2 4 2 0 2 4 2 4 2 4 2 4 2
2 4 4 4 4 4 4 4 2 0 2 4 4 4 4 4 4 4 2
2 4 2 4 2 4 2 4 2 0 2 4 2 4 2 4 2 4 2
2 4 4 4 4 4 4 4 2 0 2 4 4 4 4 4 4 4 2
2 0 2 4 2 4 2 4 2 0 2 4 2 4 2 4 2 0 2
2 51 0 4 4 4 4 4 2 0 2 4 4 4 4 4 0 19 2
2 2 2 2 2 2 2 2 2 2 2 2 2 2 2 2 2 2 2
