12:12
3 0 0 0 0 0 0 0 4 4 4 0
0 2 0 2 0 2 0 2 4 2 4 2
0 0 0 0 153 0 0 4 4 4 0 0
0 2 0 2 0 2 0 2 0 2 0 2
0 0 0 0 0 0 8 0 4 0 0 0
0 2 0 2 0 2 0 2 0 2 0 2
0 0 0 0 0 0 0 0 0 0 0 0
4 2 4 2 4 2 0 2 0 2 0 2
0 0 6 0 0 4 0 0 0 52 0 2
0 0 22 0 0 4 0 0 0 100 0 2
0 2 0 2 25 2 0 2 0 2 0 2
 
