12:12
3 0 0 0 0 0 0 0 4 4 4 0
0 2 0 2 0 2 0 2 4 2 4 2
0 0 0 0 153 0 0 4 4 4 0 0
0 2 0 2 0 2 0 2 0 2 0 2
0 0 0 0 0 0 0 0 4 0 0 0
0 2 0 2 0 2 0 2 0 2 0 2
0 0 0 0 0 0 0 0 0 0 0 0
0 2 0 2 0 2 0 2 0 2 0 2
0 0 0 0 0 0 0 0 0 0 0 0
0 0 6 0 0 0 0 6 0 0 0 0
0 2 0 2 0 2 0 2 0 2 0 2
 
