43:43
230004000330
044003040000
030044440330
334440300300 
343003334400
433033330044
000433344300
033433440330
300443003334
344430440033
340300403343
300400440041