15:9
130 66 66 66 66 66 66 66 66 66 66 66 66 66 146
50 0 0 0 0 0 0 153 0 0 0 0 0 0 82
50 0 0 0 0 0 0 0 0 0 0 0 0 0 82
50 0 0 0 0 0 0 0 0 0 0 0 0 0 82
50 0 0 0 0 0 0 0 0 0 0 0 0 0 82
50 0 0 0 0 0 0 0 0 0 0 0 0 0 82
50 0 0 0 0 0 0 0 0 0 0 0 0 0 82
50 0 0 0 0 0 0 3 0 0 0 0 0 0 82
98 34 34 34 34 34 34 34 34 34 34 34 34 34 114
